1 1 1 1 1 1 1 1 1 1
1 0 0 10 0 0 0 0 0 1
1 0 7 4 6 0 0 0 0 1
0 0 0 11 0 0 0 0 5 1
0 0 5 4 8 0 0 9 0 1
0 0 2 2 2 0 0 0 4 0
1 0 0 0 0 0 3 0 6 0
1 0 0 0 0 0 0 0 0 1
1 0 0 0 0 0 0 0 0 1
1 1 1 1 1 1 1 1 1 1
