1 1 1 1 1 1 1 1 1 1 1 1
1 0 0 0 0 0 0 0 0 0 0 1
1 0 0 0 10 4 11 0 0 0 0 1
1 0 0 0 0 0 0 0 7 4 8 1
1 0 0 0 5 4 6 0 0 0 0 1
1 0 0 3 0 3 3 3 3 0 0 1
1 0 0 0 0 0 0 0 0 0 0 1
1 0 0 2 0 0 0 9 0 0 0 1
1 0 4 6 0 0 0 0 0 0 0 1
1 0 0 1 1 1 1 1 1 1 1 1
