1 1 1 1 1 1 1 1 1 1
1 3 0 0 0 0 0 0 5 1
1 0 7 4 8 0 0 0 4 1
1 0 0 0 0 0 0 0 6 1
1 0 10 4 11 0 0 0 0 1
1 0 0 0 0 0 0 0 0 1
1 0 0 0 0 0 0 0 0 1
1 0 0 0 0 0 0 0 0 1
1 0 2 0 0 0 3 3 3 1
1 0 0 0 0 0 3 0 9 1
1 1 1 1 1 1 1 1 1 1